1...1...11..00
.1...00.....11
..............
0.11....11...1
..1...0..11...
.0...1.....00.
.....1...0..0.
0...0..0......
.0........1...
.0..1.......1.
1..0..11.....0
...0.....1....
.1..........1.
...00..1..0..1
